111111111111111111111111111111111111111
100000000011111110000000000000000000001
100000000011111110000000000000000000001
111110000011111110000000000000000000001
111110000011111110000000000000000000001
111110000000000000000000000000000000001
111110000000000000000000000000000000001
111110000000000000000000000000000000001
100000000000000000000000000000000000001
111111110001111100000000000000000000001
111111110001111100000000000000000000001
111111110001111100000000000000000000001
111111110001111100000000000000000000001
111111110000000000000000000000000000001
111111110000000000000000000000000000001
111111110000000000000000000000000000001
100000000000000000000000000000000000001
100000000000000000000000000000000000001
100000000000000000000000000000000000001
100000000000000000000000000000000000001
111111111111111111111111111111111111111