111111111111111111
100000000000000001
100000111111111001
101111000000000101
100000000000000011
10000111111111011
1000111111100001
1000011111001111
111100000001
111111111111
