11111111111111111111111111111111111111111111111111111111111111
10000000000000111111111111111111111111111111111110000000000001
10000000000000111111111111111111111111111111111110000000000001
10000000000000111111111111111111111111111111111110000000000001
10000000000000111111111111111111111111111111111110000000000001
10000000000000111111111111111111111111111111111110000000000001
10000000000000110000010000011111111111100000000010000000000001
10000000000000110000010000011111111111100000000010000000000001
10000000000000110000010000011111111111100000000010000000000001
10000000000000111001111001111111111111100000000010000011111111
11111001111111100000000000000000000000000000000000000111111111
11111001111111100000000000000000000000000000000000000000000001
10000000000000000000000000000000000001100000000000000000000001
10000000000000000000000000000000000001100000000000000000000001
10000000000000000000000000000000000001100000000000000000000001
10000000000000000000000000000000000001100000000000000000000001
11111111111111100000000000000000000001100000000000000000000001
11111111111111111111111111111111111111100000000000000000000001
11111111111111100000000000000000000000100000000000000000000001
11111111111111100000000000000000000000100000000000000000000001
11111111111111100000000000000000000000100000000000000000000001
11111111111111100000000000000000000000100000000000000000000001
11111111111111100000000000000000000000100000000000000000000001
11111111111111100000000000000000000000100000000000000000000001
11111111111111100000000000000000000000100000000000000000000001
11111111111111100000000000000000000000000000000000000000000001
11111111111111100000000000000000000000000000000000000000000001
11111111111111111111111111111111111111111111111111111111111111
