11111111111111111
10000011001110001
10000000000000001
11100000000000001
11111111001110001
11111110001000001
11111110001110011
10000000001000001
10000000001000011
111111111111111
